0 0 0 0 0 1 0 0 0 0 0 1 0 0 0 1 0 0 0
0 1 0 1 0 1 0 1 1 1 0 1 0 1 0 1 0 1 0
0 1 0 0 0 1 0 1 0 0 0 1 0 0 0 1 0 1 0
0 1 1 1 1 1 0 1 0 1 1 1 1 1 1 1 0 1 0
0 0 0 0 0 1 0 1 0 0 0 0 0 0 0 1 0 0 0
1 1 1 1 0 1 0 1 1 1 1 1 1 1 0 1 1 1 0
0 0 0 1 0 0 0 1 0 0 0 0 0 1 0 0 0 1 0
0 1 0 1 1 1 1 1 0 1 1 1 0 1 0 1 0 1 0
0 1 0 0 0 0 0 0 0 1 0 0 0 1 0 1 0 0 0
0 1 1 1 1 1 0 1 1 1 0 1 1 1 0 1 1 1 0
0 0 0 0 0 1 0 0 0 1 0 1 0 0 0 0 0 0 0
1 1 0 1 0 1 1 1 0 1 0 1 0 1 0 1 1 1 1
0 0 0 1 0 1 0 0 0 1 0 1 0 1 0 0 0 0 0
0 1 1 1 0 1 0 1 1 1 0 1 0 1 1 1 0 1 0
0 0 0 0 0 1 0 0 0 0 0 1 0 0 0 1 0 1 0
1 1 0 1 1 1 1 1 1 1 1 1 0 1 0 1 0 1 0
0 0 0 1 0 0 0 1 0 0 0 1 0 1 0 0 0 1 0
0 1 1 1 0 1 0 1 0 1 0 1 0 1 1 1 1 1 0
0 0 0 0 0 1 0 0 0 1 0 0 0 0 0 0 0 0 0
*
66CD00 573B0C